NO                         ./textures/exit.xpm


WE                                                ./textures/phinn.xpm


SO                                   ./textures/floor.xpm
EA                                                         ./textures/coin.xpm


F                                        220 , 100 , 213,123
C    225,                  123,                                                         112


11111
1N001
10001
10001
10001
10001
10001
11111