NO                         ./textures/north.xpm


WE                                                ./textures/west.xpm


SO                                   ./textures/south.xpm
EA                                                         ./textures/east.xpm


F                                        220 , 100 , 213,123
C    225,                  123,                                                         112


11111
10N01
10001
10001
10001
10001
10001
10111
111