NO                         ./textures/north.xpm


WE                                                ./textures/west.xpm


SO                                   ./textures/south.xpm
EA                                                         ./textures/east.xpm


F                                        255,0, 0
C    0,                  255,                                                         0


11111
10N01
10001
10001
10001
10001
10001
10111
111