NO                         ./textures/north.xpm


WE                                                ./textures/west.xpm


SO                                   ./textures/south.xpm
EA                                                       ./textures/east.xpm


F                                        255,0,0
C                   0,                  0,                                                         255


11111
10001
10W01
10001
10001
10001
10001
10101
11111
